4 3 3 3 3 3 3 3 3 3 3 4 3 3 3 3 3 3 3 3 3 3 3 3 4 3 3 4 4 3 3 4
4 4 3 3 3 3 3 3 4 4 3 4 3 3 3 3 3 3 3 3 3 3 3 3 4 3 3 4 4 3 3 4
4 4 4 3 3 3 3 3 4 4 3 4 3 3 3 3 3 3 3 3 3 3 3 3 4 3 3 4 4 3 3 4
4 4 4 4 3 3 3 3 3 3 3 4 3 3 3 3 3 3 3 3 3 3 3 3 4 3 3 4 4 3 3 4
4 4 4 4 4 3 3 3 3 3 3 4 3 3 3 3 3 3 3 3 3 3 3 3 4 3 3 4 4 3 3 4
4 4 4 4 4 4 3 3 3 3 3 4 3 3 3 3 3 3 3 3 3 3 3 3 4 3 3 4 4 3 3 4
4 4 4 4 4 4 4 3 3 3 3 4 3 3 3 3 3 3 3 3 3 3 3 3 4 3 3 4 4 3 3 4
4 3 3 4 4 4 4 4 3 4 4 3 3 3 3 3 3 3 3 3 3 3 3 3 4 3 3 4 4 3 3 4
4 3 3 4 4 4 4 4 3 3 3 4 3 3 3 3 3 3 3 3 3 3 3 3 4 3 3 4 4 3 3 4
4 3 3 4 4 4 4 4 4 3 3 4 3 3 3 3 3 3 3 3 3 3 3 3 4 3 3 4 4 3 3 4
4 4 4 4 4 4 4 4 4 4 3 4 3 3 3 3 3 3 3 3 3 3 3 3 4 3 3 4 4 3 3 4
4 4 4 4 4 4 4 3 3 3 3 4 3 3 3 3 3 3 3 3 3 3 3 3 4 3 3 4 4 3 3 4
4 3 3 4 4 4 4 4 4 4 4 4 3 4 B 6 7 6 B 3 3 3 3 3 3 3 3 3 3 4 3 3
4 4 4 4 4 4 4 4 3 4 4 4 3 4 6 5 5 5 6 4 3 3 3 3 3 3 3 3 3 4 3 3
4 4 4 4 4 4 4 3 3 4 4 4 3 4 7 5 8 5 7 4 3 3 3 3 3 3 3 3 3 4 3 3
4 3 3 4 4 4 4 4 4 4 4 3 4 4 6 5 5 5 6 4 3 3 3 3 3 3 3 3 3 4 3 3
4 3 3 4 4 4 4 4 3 4 4 4 3 4 B 6 7 6 B 4 3 3 3 3 3 3 3 3 3 4 3 3
4 4 4 4 4 4 4 4 4 4 4 4 3 4 4 4 4 4 4 4 3 3 3 3 3 3 3 3 3 4 3 3
4 4 4 4 4 4 4 4 4 3 3 4 3 3 3 3 3 3 3 3 3 3 3 3 4 3 3 4 4 3 3 4
4 3 3 4 4 4 4 4 3 3 3 4 3 3 3 3 3 3 3 3 3 3 3 3 4 3 3 4 4 3 3 4
4 3 3 4 4 4 4 4 4 3 3 4 3 3 3 3 3 3 3 3 3 3 3 3 4 3 3 4 4 3 3 4
4 4 4 4 4 4 4 4 4 4 3 4 3 3 3 3 3 3 3 3 3 3 3 3 4 3 3 4 4 3 3 4
4 4 4 4 4 4 4 3 3 3 3 4 3 3 3 3 3 3 3 3 3 3 3 3 4 3 3 4 4 3 3 4
4 3 3 4 4 4 4 4 3 3 3 4 3 3 3 3 3 3 3 3 3 3 3 3 4 3 3 4 4 3 3 4
4 3 3 4 4 4 4 4 4 3 3 4 3 3 3 3 3 3 3 3 3 3 3 3 4 3 3 4 4 3 3 4
4 4 4 4 4 4 4 4 4 4 3 4 3 3 3 3 3 3 3 3 3 3 3 3 4 3 3 4 4 3 3 4
4 4 4 4 4 4 4 3 3 3 3 4 3 3 3 3 3 3 3 3 3 3 3 3 4 3 3 4 4 3 3 4
4 3 3 4 4 4 4 4 3 3 3 4 3 3 3 3 3 3 3 3 3 3 3 3 4 3 3 4 4 3 3 4
4 3 3 4 4 4 4 4 4 3 3 4 3 3 3 3 3 3 3 3 3 3 3 3 4 3 3 4 4 3 3 4
4 4 4 4 4 4 4 4 4 4 3 4 3 3 3 3 3 3 3 3 3 3 3 3 4 3 3 4 4 3 3 4
4 4 4 4 4 4 4 3 3 3 3 4 3 3 3 3 3 3 3 3 3 3 3 3 4 3 3 4 4 3 3 4
4 3 3 4 4 4 4 4 3 3 3 4 3 3 3 3 3 3 3 3 3 3 3 3 4 3 3 4 4 3 3 4
4 3 3 4 4 4 4 4 4 3 3 4 3 3 3 3 3 3 3 3 3 3 3 3 4 3 3 4 4 3 3 4
4 4 4 4 4 4 4 4 4 4 3 4 3 3 3 3 3 3 3 3 3 3 3 3 4 3 3 4 4 3 3 4
4 4 4 4 4 4 4 3 3 3 3 4 3 3 3 3 3 3 3 3 3 3 3 3 4 3 3 4 4 3 3 4
4 3 3 4 4 4 4 4 3 3 3 4 3 3 3 3 3 3 3 3 3 3 3 3 4 3 3 4 4 3 3 4