4 3 3 3 3 3 3 3 3 3 3 4 3 3 3 3 3 3 3 3 3 3
4 4 3 3 3 3 3 3 4 4 3 4 3 3 3 3 3 3 3 3 3 3
4 4 4 3 3 3 3 3 4 4 3 4 3 3 3 3 3 3 3 3 3 3
4 4 4 4 3 3 3 3 3 3 3 4 3 3 3 3 3 3 3 3 3 3
4 4 4 4 4 3 3 3 3 3 3 4 3 3 3 3 3 3 3 3 3 3
4 4 4 4 4 4 3 3 3 3 3 4 3 3 3 3 3 3 3 3 3 3
4 4 4 4 4 4 4 3 3 3 3 4 3 3 3 3 3 3 3 3 3 3
4 3 3 4 4 4 4 4 3 4 4 3 3 3 3 3 3 3 3 3 3 3
4 3 3 4 4 4 4 4 4 B 6 7 6 B 3 3 3 3 3 3 3 3
4 4 4 4 4 4 4 4 3 6 5 5 5 6 4 3 3 3 3 3 3 3
4 4 4 4 4 4 4 3 3 7 5 8 5 7 4 3 3 3 3 3 3 3
4 3 3 4 4 4 4 4 4 6 5 5 5 6 4 3 3 3 3 3 3 3
4 3 3 4 4 4 4 4 3 B 6 7 6 B 4 3 3 3 3 3 3 3
4 4 4 4 4 4 4 4 4 4 4 4 4 4 4 3 3 3 3 3 3 3
4 4 4 4 4 4 4 4 4 3 3 4 3 3 3 3 3 3 3 3 3 3
4 3 3 4 4 4 4 4 3 3 3 4 3 3 3 3 3 3 3 3 3 3
4 3 3 4 4 4 4 4 4 3 3 4 3 3 3 3 3 3 3 3 3 3
4 4 4 4 4 4 4 4 4 4 3 4 3 3 3 3 3 3 3 3 3 3
4 4 4 4 4 4 4 3 3 3 3 4 3 3 3 3 3 3 3 3 3 3
4 3 3 4 4 4 4 4 3 3 3 4 3 3 3 3 3 3 3 3 3 3